R    921         500

NO          tex/wall_1.xpm

SO ./tex/wall_2.xpm
WE tex/wall_3.xpm

EA   ./tex/wall_4.xpm

S       tex/sprite.xpm
F 124   ,148 ,161
C         101   ,  115,   140



        1111111111111111111111111
        1000000002110000000000021
        1011000001110000002000201
        1001000000000000000000201
111111111011000001110000000000021
100000000011220221110111110111111
11110111111111011100000010001
11110111111111011101010010001
11000000110101011100000010001
10002000000000001100000010001
10000000000000001101010010001
110000011101010111110111110111
11110111 1110101 101111010N01
11111111 1111111 111111111111