R    920         608

NO          files/redbrick.xpm

SO ./files/redbrick.xpm
WE files/redbrick.xpm

EA   ./files/redbrick.xpm

S       files/fast.xpm
F 60   ,60 ,60
C         50   ,  50,   50



        1111111111111111111111111
        1000000000110000000000021
        1011000001110000002000201
        1001000000000000000000201
111111111011000001110000000000021
100000000011000001110111110111111
11110111111111011100000010001
11110111111111011101010010001
11000000110101011100000010001
10002000000000001100000010001
10000000000000001101010010001
110000011101010111110111110111
11110111 1110101 101111010N01
11111111 1111111 111111111111