R    640         440

NO          ./files/north.xpm


SO ./files/south.xpm
WE files/west.xpm

EA   ./files/east.xpm

S       files/megaman.xpm
F 98   ,71 ,4
C         0   ,  124,   251

111111111111111111111
100000001000000000001
100000000100000000001
1E0000000010000000001
100000000000000000001
100000001000000000001
111111111111111111111


        1111111111111111111111111
        1000000000110000000000001
        1011000001110000002000001
        1001000000000000000000001
111111111011000001110000000000001
100000000011000001110111100011111
11110111111111011100000010001
11110111111111011101010010001
11000000110101011100000010001
10002000000000001100000010001
10000000000000001101010010001
110000011101010111110111100011
11110111 1110101 101111010N01
11111111 1111111 111111111111